M00000H00000M
M00000000000M
M00000000000M
M00000000000M
M00000000000M
M00000000000M
M0W0000000W0M
