M00000H00000M
M00000000000M
M00000000000M
M00M0000MM00M
M00000000W00M
M0000W0W0000M
M0W000W00000M
