M00000H00000M
M0W000000000M
M00000000000M
M00000W00000M
M00000000000M
M00000000000M
M0W000000000M
