MMMMMMMMMMMMMMMMMM
M00000H0000000000M
M0000000000000000M
M0000000000000000M
M00M0000MM0000000M
M00000000W0000000M
M0000W00000000000M
M0W00000000000000M
M0W0000000M00M0M0M
M0W0000000M000000M
M0W00000000000000M
MMMMMMMMMMMMMMMMMM
