M00000H00000M
M00C00000000M
M00000C00000M
M00M0000MM00M
M00000000C00M
M0000C0C0000M
M0C000C00000M
