MMMMMMMMMMMMMMMMMM
M00000H0000000000M
M000000000000W000M
M0000000000000000M
M00M0000MM0000W00M
M00000W0000000000M
M0000000000000000M
M00W0000000000W00M
M000000000M00M0M0M
M000000000M000000M
M0000W00000000000M
MMMMMMMMMMMMMMMMMM
