M00000H00000M
M00000000000M
M00000000000M
M00M0M00MM00M
M00W00000W00M
M0000W000000M
M0W000W00000M
