M00000H00000M
M00000000000M
M00000000000M
M000W0000000M
M00000000000M
M00000000W00M
M00000000000M
