ABCDEFGHIJKL1
0000000000002
0000000000003
0000000000004
0000000000005
0000000000006
0000000000007
